* MAP
- w w w w w w w w w w w w w w w w w w
- w f f f f f f f f f f f f f f f f w
- w f f f f f f f f f f f f f f f f w
- w f f w f f f f f f f f f f w f f w
- w b f w f f f v v v f f f f w f r w
- w b f w f f f v v v f f f f w f r w
- w b f w f f f v v v f f f f w f r w
- w f f w f f f f f f f f f f w f f w
- w f f f f f f f f f f f f f f f f w
- w f f f f f f f f f f f f f f f f w
- w w w w w w w w w w w w w w w w w w
* TEXTURE
w:MAP_WALL_0
f:MAP_FLOOR_0
v:MAP_VOID_0
b:MAP_FLOOR_0
r:MAP_FLOOR_0
B:MAP_FLOOR_0
R:MAP_FLOOR_0
D:MAP_FLOOR_0